{
    "map": [ 
        [ 1, 1, 1, 1, 1, 1, 1, 1, 1, 1, 1, 1, 24, 2, 2 ],
        [ 1, 1, 1, 1, 1, 1, 1, 1, 1, 1, 1, 24, 25, 2, 2 ],
        [ 1, 1, 1, 1, 1, 1, 1, 1, 1, 1, 3, 25, 27, 2, 2 ],
        [ 1, 1, 1, 1, 1, 1, 1, 1, 1, 1, 1, 26, 28, 2, 2 ],
        [ 1, 1, 1, 1, 1, 1, 1, 1, 1, 1, 1, 1, 26, 2, 2 ],
        [ 1, 1, 1, 1, 1, 1, 1, 1, 1, 1, 1, 1, 1, 2, 2 ],
        [ 1, 1, 1, 1, 1, 1, 1, 1, 1, 1, 1, 1, 1, 2, 2 ],
        [ 1, 1, 1, 1, 1, 1, 1, 1, 1, 1, 1, 1, 1, 2, 2 ],
        [ 1, 1, 1, 33, 55, 1, 1, 1, 1, 1, 1, 1, 1, 2, 2 ],
        [ 1, 1, 1, 34, 56, 1, 1, 1, 1, 1, 1, 1, 1, 2, 2 ],
        [ 1, 1, 1, 35, 57, 1, 1, 1, 1, 1, 1, 1, 1, 2, 2 ],
        [ 1, 1, 1, 1, 1, 1, 1, 1, 1, 1, 1, 1, 4, 2, 2 ],
        [ 1, 1, 1, 1, 1, 1, 1, 1, 1, 1, 1, 1, 5, 2, 2 ],
        [ 1, 1, 1, 1, 1, 1, 1, 1, 1, 1, 1, 1, 5, 2, 2 ],
        [ 1, 1, 1, 1, 1, 1, 1, 1, 1, 1, 1, 1, 5, 2, 2 ],
        [ 1, 1, 1, 1, 1, 1, 1, 1, 1, 1, 1, 1, 6, 2, 2 ],
        [ 1, 1, 1, 1, 1, 1, 1, 1, 1, 8, 1, 1, 24, 2, 2 ],
        [ 1, 1, 1, 1, 1, 1, 1, 1, 1, 1, 1, 3, 25, 2, 2 ],
        [ 1, 1, 1, 1, 1, 1, 1, 1, 1, 1, 1, 1, 26, 2, 2 ],
        [ 1, 1, 33, 55, 1, 1, 1, 1, 1, 1, 1, 1, 1, 2, 2 ],
        [ 1, 1, 34, 56, 1, 1, 1, 1, 1, 7, 1, 1, 1, 2, 2 ],
        [ 1, 1, 35, 57, 1, 1, 1, 1, 1, 8, 1, 1, 1, 2, 2 ],
        [ 1, 1, 1, 1, 1, 8, 1, 1, 1, 7, 1, 1, 1, 2, 2 ],
        [ 1, 1, 1, 1, 1, 1, 1, 1, 1, 8, 1, 1, 4, 2, 2 ],
        [ 1, 1, 1, 1, 1, 1, 1, 1, 1, 7, 1, 1, 5, 2, 2 ],
        [ 1, 1, 1, 1, 1, 1, 1, 1, 1, 1, 1, 1, 6, 2, 2 ],
        [ 1, 1, 1, 1, 1, 1, 1, 1, 1, 1, 1, 1, 1, 2, 2 ],
        [ 1, 1, 1, 33, 55, 1, 1, 1, 1, 1, 1, 1, 1, 2, 2 ],
        [ 1, 1, 1, 34, 56, 1, 1, 1, 1, 1, 1, 16, 38, 2, 2 ],
        [ 1, 1, 1, 34, 56, 1, 1, 1, 1, 1, 1, 17, 39, 2, 2 ],
        [ 1, 1, 1, 34, 56, 1, 1, 1, 1, 1, 1, 1, 1, 2, 2 ],
        [ 1, 1, 1, 35, 57, 1, 1, 1, 1, 1, 1, 1, 1, 2, 2 ],
        [ 1, 1, 1, 1, 1, 1, 1, 1, 1, 1, 1, 1, 1, 2, 2 ],
        [ 1, 1, 1, 1, 1, 1, 1, 1, 1, 1, 1, 1, 1, 2, 2 ],
        [ 1, 1, 1, 1, 1, 1, 1, 1, 1, 1, 1, 1, 1, 2, 2 ],
        [ 1, 1, 1, 1, 1, 1, 1, 1, 1, 1, 1, 1, 1, 2, 2 ],
        [ 1, 1, 33, 55, 1, 1, 1, 1, 1, 1, 1, 1, 1, 2, 2 ],
        [ 1, 1, 34, 56, 1, 1, 1, 1, 1, 1, 1, 1, 1, 2, 2 ],
        [ 1, 1, 34, 56, 1, 1, 1, 1, 1, 1, 16, 38, 38, 2, 2 ],
        [ 1, 1, 35, 57, 1, 1, 1, 1, 1, 1, 17, 39, 39, 2, 2 ],
        [ 1, 1, 1, 1, 1, 1, 1, 1, 1, 1, 1, 1, 1, 2, 2 ],
        [ 1, 1, 1, 1, 1, 1, 1, 1, 1, 1, 1, 1, 4, 2, 2 ],
        [ 1, 1, 1, 1, 1, 1, 1, 1, 1, 1, 1, 1, 5, 2, 2 ],
        [ 1, 1, 1, 1, 1, 1, 1, 1, 1, 1, 1, 1, 5, 2, 2 ],
        [ 1, 1, 1, 1, 1, 1, 1, 1, 1, 1, 1, 1, 6, 2, 2 ],
        [ 1, 1, 1, 1, 1, 1, 1, 1, 1, 1, 1, 1, 1, 2, 2 ],
        [ 1, 1, 1, 1, 1, 1, 1, 1, 1, 16, 38, 38, 38, 2, 2 ],
        [ 1, 1, 1, 1, 1, 1, 1, 1, 1, 17, 39, 39, 39, 2, 2 ],
        [ 1, 1, 1, 1, 1, 1, 1, 1, 1, 1, 1, 1, 24, 2, 2 ],
        [ 1, 1, 1, 1, 1, 1, 1, 1, 1, 1, 1, 24, 25, 2, 2 ],
        [ 1, 1, 1, 1, 1, 1, 1, 1, 1, 1, 3, 25, 27, 2, 2 ],
        [ 1, 1, 1, 1, 1, 1, 1, 1, 1, 1, 1, 26, 28, 2, 2 ],
        [ 1, 1, 1, 1, 1, 1, 1, 1, 1, 1, 1, 1, 26, 2, 2 ],
        [ 1, 1, 1, 1, 1, 1, 1, 1, 1, 1, 1, 1, 1, 2, 2 ],
        [ 1, 1, 1, 1, 1, 1, 1, 1, 1, 1, 1, 1, 1, 2, 2 ],
        [ 1, 1, 1, 1, 1, 1, 1, 1, 1, 1, 1, 1, 1, 2, 2 ],
        [ 1, 1, 1, 33, 55, 1, 1, 1, 1, 1, 1, 1, 1, 2, 2 ],
        [ 1, 1, 1, 34, 56, 1, 1, 1, 1, 16, 38, 38, 38, 2, 2 ],
        [ 1, 1, 1, 35, 57, 1, 1, 1, 1, 17, 39, 39, 39, 2, 2 ],
        [ 1, 1, 1, 1, 1, 1, 1, 1, 1, 1, 1, 1, 4, 2, 2 ],
        [ 1, 1, 1, 1, 1, 1, 1, 1, 1, 1, 1, 1, 5, 2, 2 ],
        [ 1, 1, 1, 1, 1, 1, 1, 1, 1, 1, 1, 1, 5, 2, 2 ],
        [ 1, 1, 1, 1, 1, 1, 1, 1, 1, 1, 1, 1, 5, 2, 2 ],
        [ 1, 1, 1, 1, 1, 1, 1, 1, 1, 1, 1, 1, 6, 2, 2 ],
        [ 1, 1, 1, 1, 1, 1, 1, 1, 115, 1, 1, 1, 24, 2, 2 ],
        [ 1, 1, 1, 1, 1, 1, 1, 1, 1, 1, 1, 3, 25, 2, 2 ],
        [ 1, 1, 1, 1, 1, 1, 1, 1, 1, 1, 1, 1, 26, 2, 2 ],
        [ 1, 1, 33, 55, 1, 1, 1, 1, 1, 1, 1, 1, 1, 2, 2 ],
        [ 1, 1, 34, 56, 1, 1, 1, 1, 1, 1, 1, 1, 1, 2, 2 ],
        [ 1, 1, 35, 57, 1, 1, 1, 1, 1, 1, 1, 1, 1, 1, 1 ],
        [ 1, 1, 1, 1, 1, 1, 1, 1, 1, 1, 1, 1, 1, 1, 1 ],
        [ 1, 1, 1, 1, 1, 1, 1, 1, 1, 1, 1, 1, 4, 2, 2 ],
        [ 1, 1, 1, 1, 1, 1, 1, 1, 1, 1, 1, 1, 5, 2, 2 ],
        [ 1, 1, 1, 1, 1, 1, 1, 1, 1, 1, 1, 1, 6, 2, 2 ],
        [ 1, 1, 1, 1, 1, 1, 1, 1, 1, 1, 1, 1, 1, 2, 2 ],
        [ 1, 1, 1, 33, 55, 1, 1, 1, 1, 1, 1, 1, 1, 2, 2 ],
        [ 1, 1, 1, 34, 56, 1, 1, 1, 1, 1, 1, 1, 1, 2, 2 ],
        [ 1, 1, 1, 34, 56, 1, 1, 1, 1, 7, 1, 1, 1, 2, 2 ],
        [ 1, 1, 1, 34, 56, 1, 1, 1, 1, 8, 1, 1, 1, 2, 2 ],
        [ 1, 1, 1, 35, 57, 1, 1, 1, 1, 7, 1, 1, 1, 2, 2 ],
        [ 1, 1, 1, 1, 1, 7, 1, 1, 1, 1, 1, 1, 1, 2, 2 ],
        [ 1, 1, 1, 1, 1, 7, 1, 1, 1, 1, 1, 1, 1, 2, 2 ],
        [ 1, 1, 1, 1, 1, 7, 1, 1, 1, 1, 1, 1, 1, 2, 2 ],
        [ 1, 1, 1, 1, 1, 7, 1, 1, 1, 1, 1, 1, 1, 2, 2 ],
        [ 1, 1, 33, 55, 1, 7, 1, 1, 1, 1, 1, 1, 1, 2, 2 ],
        [ 1, 1, 34, 56, 1, 7, 1, 1, 1, 1, 1, 1, 1, 2, 2 ],
        [ 1, 1, 34, 56, 1, 7, 1, 1, 1, 1, 1, 1, 1, 1, 1 ],
        [ 1, 1, 35, 57, 1, 7, 1, 1, 1, 1, 1, 1, 1, 1, 1 ],
        [ 1, 1, 1, 1, 1, 1, 1, 1, 1, 1, 1, 1, 1, 1, 1 ],
        [ 1, 1, 1, 1, 1, 1, 1, 1, 1, 1, 1, 1, 4, 2, 2 ],
        [ 1, 1, 1, 1, 1, 1, 1, 1, 1, 1, 1, 1, 5, 2, 2 ],
        [ 1, 1, 1, 1, 1, 7, 1, 1, 1, 1, 1, 1, 5, 2, 2 ],
        [ 1, 1, 1, 1, 1, 7, 1, 1, 1, 1, 1, 1, 6, 2, 2 ],
        [ 1, 1, 1, 1, 1, 7, 1, 1, 1, 1, 1, 1, 1, 2, 2 ],
        [ 1, 1, 1, 1, 1, 8, 1, 1, 1, 7, 1, 1, 1, 2, 2 ],
        [ 1, 1, 1, 1, 1, 1, 1, 1, 1, 1, 1, 1, 1, 2, 2 ],
        [ 1, 1, 1, 1, 1, 1, 1, 1, 1, 1, 1, 1, 24, 2, 2 ],
        [ 1, 1, 1, 1, 1, 1, 1, 1, 1, 1, 1, 24, 25, 2, 2 ],
        [ 1, 1, 1, 1, 1, 1, 1, 1, 1, 1, 3, 25, 27, 2, 2 ],
        [ 1, 1, 1, 1, 1, 1, 1, 1, 1, 1, 1, 26, 28, 2, 2 ],
        [ 1, 1, 1, 1, 1, 1, 1, 1, 1, 7, 1, 1, 26, 2, 2 ],
        [ 1, 1, 1, 1, 1, 1, 1, 1, 1, 7, 1, 1, 1, 2, 2 ],
        [ 1, 1, 1, 1, 1, 1, 1, 1, 1, 1, 1, 1, 1, 2, 2 ],
        [ 1, 1, 1, 1, 1, 1, 1, 1, 1, 1, 1, 1, 1, 2, 2 ],
        [ 1, 1, 1, 33, 55, 1, 1, 1, 1, 1, 1, 1, 1, 2, 2 ],
        [ 1, 1, 1, 34, 56, 1, 1, 1, 1, 1, 1, 1, 1, 2, 2 ],
        [ 1, 1, 1, 35, 57, 1, 1, 1, 1, 8, 1, 1, 1, 2, 2 ],
        [ 1, 1, 1, 1, 1, 1, 1, 1, 1, 1, 1, 1, 4, 2, 2 ],
        [ 1, 1, 1, 1, 1, 1, 1, 1, 1, 1, 1, 1, 5, 2, 2 ],
        [ 1, 1, 1, 1, 1, 8, 1, 1, 1, 8, 1, 1, 5, 2, 2 ],
        [ 1, 1, 1, 1, 1, 1, 1, 1, 1, 1, 1, 1, 5, 2, 2 ],
        [ 1, 1, 1, 1, 1, 1, 1, 1, 1, 1, 1, 1, 6, 2, 2 ],
        [ 1, 1, 1, 1, 1, 1, 1, 1, 1, 8, 1, 1, 24, 2, 2 ],
        [ 1, 1, 1, 1, 1, 1, 1, 1, 1, 1, 1, 3, 25, 2, 2 ],
        [ 1, 1, 1, 1, 1, 1, 1, 1, 1, 1, 1, 1, 26, 2, 2 ],
        [ 1, 1, 33, 55, 1, 1, 1, 1, 1, 1, 1, 1, 1, 2, 2 ],
        [ 1, 1, 34, 56, 1, 1, 1, 1, 1, 1, 1, 1, 1, 2, 2 ],
        [ 1, 1, 35, 57, 1, 1, 1, 1, 1, 1, 1, 1, 1, 2, 2 ],
        [ 1, 1, 1, 1, 1, 1, 1, 1, 1, 7, 1, 1, 1, 2, 2 ],
        [ 1, 1, 1, 1, 1, 1, 1, 1, 1, 1, 1, 1, 4, 2, 2 ],
        [ 1, 1, 1, 1, 1, 1, 1, 1, 1, 1, 1, 1, 5, 2, 2 ],
        [ 1, 1, 1, 1, 1, 7, 1, 1, 1, 1, 1, 1, 6, 2, 2 ],
        [ 1, 1, 1, 1, 1, 7, 1, 1, 1, 1, 1, 1, 1, 2, 2 ],
        [ 1, 1, 1, 33, 55, 7, 1, 1, 1, 1, 1, 1, 1, 2, 2 ],
        [ 1, 1, 1, 34, 56, 1, 1, 1, 1, 1, 1, 1, 1, 2, 2 ],
        [ 1, 1, 1, 34, 56, 1, 1, 1, 1, 1, 1, 1, 1, 2, 2 ],
        [ 1, 1, 1, 34, 56, 1, 1, 1, 1, 1, 1, 1, 1, 2, 2 ],
        [ 1, 1, 1, 35, 57, 1, 1, 1, 1, 1, 1, 1, 1, 2, 2 ],
        [ 1, 1, 1, 1, 1, 7, 1, 1, 1, 1, 1, 1, 1, 2, 2 ],
        [ 1, 1, 1, 1, 1, 8, 1, 1, 1, 7, 1, 1, 1, 2, 2 ],
        [ 1, 1, 1, 1, 1, 8, 1, 1, 1, 7, 1, 1, 1, 2, 2 ],
        [ 1, 1, 1, 1, 1, 7, 1, 1, 1, 1, 1, 1, 1, 2, 2 ],
        [ 1, 1, 33, 55, 1, 1, 1, 1, 1, 1, 1, 1, 1, 2, 2 ],
        [ 1, 1, 34, 56, 1, 1, 1, 1, 1, 1, 1, 1, 1, 2, 2 ],
        [ 1, 1, 34, 56, 1, 1, 1, 1, 1, 1, 1, 1, 78, 2, 2 ],
        [ 1, 1, 35, 57, 1, 1, 1, 1, 1, 1, 1, 78, 78, 2, 2 ],
        [ 1, 1, 1, 1, 1, 1, 1, 1, 1, 1, 78, 78, 78, 2, 2 ],
        [ 1, 1, 1, 1, 1, 1, 1, 1, 1, 78, 78, 78, 78, 2, 2 ],
        [ 1, 1, 1, 1, 1, 1, 1, 1, 1, 1, 1, 1, 5, 2, 2 ],
        [ 1, 1, 1, 1, 1, 1, 1, 1, 1, 1, 1, 1, 5, 2, 2 ],
        [ 1, 1, 1, 1, 1, 1, 1, 1, 1, 78, 78, 78, 78, 2, 2 ],
        [ 1, 1, 1, 1, 1, 1, 1, 1, 1, 1, 78, 78, 78, 2, 2 ],
        [ 1, 1, 1, 1, 1, 1, 1, 1, 1, 1, 1, 78, 78, 2, 2 ],
        [ 1, 1, 1, 1, 1, 1, 1, 1, 1, 1, 1, 1, 78, 2, 2 ],
        [ 1, 1, 1, 1, 1, 1, 1, 1, 1, 1, 1, 1, 24, 2, 2 ],
        [ 1, 1, 1, 1, 1, 1, 1, 1, 1, 1, 1, 24, 25, 2, 2 ],
        [ 1, 1, 1, 1, 1, 1, 1, 1, 1, 1, 3, 25, 27, 2, 2 ],
        [ 1, 1, 1, 1, 1, 1, 1, 1, 1, 1, 1, 26, 28, 2, 2 ],
        [ 1, 1, 1, 1, 1, 1, 1, 1, 1, 1, 1, 1, 78, 2, 2 ],
        [ 1, 1, 1, 1, 1, 1, 1, 1, 1, 1, 1, 78, 78, 2, 2 ],
        [ 1, 1, 1, 1, 1, 1, 1, 1, 1, 1, 78, 78, 78, 2, 2 ],
        [ 1, 1, 1, 1, 1, 1, 1, 1, 1, 78, 78, 78, 78, 2, 2 ],
        [ 1, 1, 1, 33, 55, 1, 1, 1, 1, 78, 78, 78, 78, 2, 2 ],
        [ 1, 1, 1, 34, 56, 1, 1, 1, 1, 1, 1, 1, 1, 1, 1 ],
        [ 1, 1, 1, 35, 57, 1, 1, 1, 1, 1, 1, 1, 1, 1, 1 ],
        [ 1, 1, 1, 1, 1, 1, 1, 1, 1, 78, 78, 78, 78, 2, 2 ],
        [ 1, 1, 1, 1, 1, 1, 1, 1, 1, 1, 78, 78, 78, 2, 2 ],
        [ 1, 1, 1, 1, 1, 1, 1, 1, 1, 1, 1, 78, 78, 2, 2 ],
        [ 1, 1, 1, 1, 1, 1, 1, 1, 1, 1, 1, 1, 78, 2, 2 ],
        [ 1, 1, 1, 1, 1, 1, 1, 1, 1, 1, 1, 1, 6, 2, 2 ],
        [ 1, 1, 1, 1, 1, 1, 1, 1, 1, 1, 1, 1, 24, 2, 2 ],
        [ 1, 1, 1, 1, 1, 1, 1, 1, 1, 1, 1, 3, 25, 2, 2 ],
        [ 1, 1, 1, 1, 1, 1, 1, 1, 1, 1, 1, 1, 26, 2, 2 ],
        [ 1, 1, 33, 55, 1, 1, 1, 1, 1, 1, 1, 16, 38, 2, 2 ],
        [ 1, 1, 34, 56, 1, 1, 1, 1, 1, 1, 1, 17, 39, 2, 2 ],
        [ 1, 1, 35, 57, 1, 1, 1, 1, 1, 1, 1, 1, 1, 2, 2 ],
        [ 1, 1, 1, 1, 1, 1, 1, 1, 1, 1, 1, 1, 1, 2, 2 ],
        [ 1, 1, 1, 1, 1, 1, 1, 1, 1, 1, 1, 1, 4, 2, 2 ],
        [ 1, 1, 1, 1, 1, 1, 1, 1, 1, 7, 1, 1, 5, 2, 2 ],
        [ 1, 1, 1, 1, 1, 1, 1, 1, 1, 7, 1, 1, 6, 2, 2 ],
        [ 1, 1, 1, 1, 1, 1, 1, 1, 1, 8, 1, 1, 1, 2, 2 ],
        [ 1, 1, 1, 33, 55, 1, 1, 1, 1, 7, 1, 1, 1, 2, 2 ],
        [ 1, 1, 1, 34, 56, 1, 1, 1, 1, 1, 1, 1, 1, 2, 2 ],
        [ 1, 1, 1, 34, 56, 1, 1, 1, 1, 1, 1, 1, 1, 2, 2 ],
        [ 1, 1, 1, 34, 56, 1, 1, 1, 1, 1, 1, 1, 1, 2, 2 ],
        [ 1, 1, 1, 35, 57, 1, 1, 1, 1, 1, 1, 1, 1, 2, 2 ],
        [ 1, 1, 1, 1, 1, 1, 1, 1, 1, 1, 1, 1, 1, 2, 2 ],
        [ 1, 1, 1, 1, 1, 1, 1, 1, 1, 1, 1, 1, 1, 2, 2 ],
        [ 1, 1, 1, 1, 1, 1, 1, 1, 1, 1, 1, 1, 1, 2, 2 ],
        [ 1, 1, 1, 1, 1, 1, 1, 1, 1, 1, 1, 16, 38, 2, 2 ],
        [ 1, 1, 33, 55, 1, 1, 1, 1, 1, 1, 1, 17, 39, 2, 2 ],
        [ 1, 1, 34, 56, 1, 1, 1, 1, 1, 1, 1, 1, 78, 2, 2 ],
        [ 1, 1, 34, 56, 1, 1, 1, 1, 1, 1, 1, 78, 78, 2, 2 ],
        [ 1, 1, 35, 57, 1, 1, 1, 1, 1, 1, 78, 78, 78, 2, 2 ],
        [ 1, 1, 1, 1, 1, 1, 1, 1, 1, 78, 78, 78, 78, 2, 2 ],
        [ 1, 1, 1, 1, 1, 1, 1, 1, 78, 78, 78, 78, 78, 2, 2 ],
        [ 1, 1, 1, 1, 1, 1, 1, 78, 78, 78, 78, 78, 78, 2, 2 ],
        [ 1, 1, 1, 1, 1, 1, 78, 78, 78, 78, 78, 78, 78, 2, 2 ],
        [ 1, 1, 1, 1, 1, 78, 78, 78, 78, 78, 78, 78, 78, 2, 2 ],
        [ 1, 1, 1, 1, 1, 78, 78, 78, 78, 78, 78, 78, 78, 2, 2 ],
        [ 1, 1, 1, 1, 1, 1, 1, 1, 1, 1, 1, 1, 1, 2, 2 ],
        [ 1, 1, 1, 1, 1, 1, 1, 1, 1, 1, 1, 1, 1, 2, 2 ],
        [ 1, 1, 1, 1, 1, 1, 1, 1, 1, 1, 1, 1, 24, 2, 2 ],
        [ 1, 1, 1, 1, 1, 1, 1, 1, 1, 1, 1, 24, 25, 2, 2 ],
        [ 1, 1, 1, 1, 1, 1, 1, 1, 1, 1, 3, 25, 27, 2, 2 ],
        [ 1, 1, 1, 1, 1, 1, 1, 1, 1, 1, 1, 26, 28, 2, 2 ],
        [ 1, 1, 1, 1, 1, 1, 1, 1, 1, 1, 1, 1, 26, 2, 2 ],
        [ 1, 1, 1, 1, 1, 1, 1, 1, 1, 1, 1, 1, 1, 2, 2 ],
        [ 1, 1, 100, 103, 103, 103, 103, 103, 103, 103, 103, 103, 78, 2, 2 ],
        [ 1, 1, 1, 1, 1, 1, 1, 1, 1, 1, 1, 1, 1, 2, 2 ],
        [ 1, 1, 1, 33, 55, 1, 1, 1, 1, 1, 1, 1, 1, 2, 2 ],
        [ 1, 1, 1, 34, 56, 1, 1, 1, 1, 1, 1, 1, 1, 2, 2 ],
        [ 1, 1, 1, 35, 57, 1, 1, 1, 1, 1, 45, 47, 47, 2, 2 ],
        [ 1, 1, 1, 1, 1, 1, 1, 1, 45, 67, 23, 47, 47, 2, 2 ],
        [ 1, 1, 1, 1, 1, 1, 1, 1, 45, 47, 23, 46, 68, 2, 2 ],
        [ 1, 1, 1, 1, 1, 1, 1, 1, 45, 69, 23, 47, 47, 2, 2 ],
        [ 1, 1, 1, 1, 1, 1, 1, 1, 1, 1, 45, 47, 47, 2, 2 ],
        [ 1, 1, 1, 1, 1, 1, 1, 1, 1, 1, 1, 1, 6, 2, 2 ],
        [ 1, 1, 1, 1, 1, 1, 1, 1, 1, 1, 1, 1, 24, 2, 2 ],
        [ 1, 1, 1, 1, 1, 1, 1, 1, 1, 1, 1, 3, 25, 2, 2 ],
        [ 1, 1, 1, 1, 1, 1, 1, 1, 1, 1, 1, 1, 26, 2, 2 ],
        [ 1, 1, 33, 55, 1, 1, 1, 1, 1, 1, 1, 1, 1, 2, 2 ],
        [ 1, 1, 34, 56, 1, 1, 1, 1, 1, 1, 1, 1, 1, 2, 2 ],
        [ 1, 1, 35, 57, 1, 1, 1, 1, 1, 1, 1, 1, 1, 2, 2 ],
        [ 1, 1, 1, 1, 1, 1, 1, 1, 1, 1, 1, 1, 1, 2, 2 ],
        [ 1, 1, 1, 1, 1, 1, 1, 1, 1, 1, 1, 1, 4, 2, 2 ],
        [ 1, 1, 1, 1, 1, 1, 1, 1, 1, 1, 1, 1, 5, 2, 2 ],
        [ 1, 1, 1, 1, 1, 1, 1, 1, 1, 1, 1, 1, 6, 2, 2 ],
        [ 1, 1, 1, 1, 1, 1, 1, 1, 1, 1, 1, 1, 1, 2, 2 ],
        [ 1, 1, 1, 33, 55, 1, 1, 1, 1, 1, 1, 1, 1, 2, 2 ],
        [ 1, 1, 1, 34, 56, 1, 1, 1, 1, 1, 1, 1, 1, 2, 2 ],
        [ 1, 1, 1, 34, 56, 1, 1, 1, 1, 1, 1, 1, 1, 2, 2 ],
        [ 1, 1, 1, 34, 56, 1, 1, 1, 1, 1, 1, 1, 1, 2, 2 ],
        [ 1, 1, 1, 35, 57, 1, 1, 1, 1, 1, 1, 1, 1, 2, 2 ]
    ]
}