{
    "entities": [
        {"type": "spawn", "x": 5, "y": 8.75},
        {"type": "goomba", "x": 8, "y": 8.75}
    ],
    
    "tileMaps": ["smb3-grass", "smb3-general", "smb3-overworld"],

    "lookup": [
        {
            "tileMap": 1,
            "tileNo": 10
        },
        
        {
            "tileMap": 1,
            "tileNo": 2
        },
        
        {
            "tileMap": 1,
            "tileNo": 11
        },
        
        {
            "tileMap": 1,
            "tileNo": 9
        },
        
        {
            "tileMap": 1,
            "tileNo": 27
        },
        
        {
            "tileMap": 1,
            "tileNo": 35
        },
        
        {
            "tileMap": 1,
            "tileNo": 38
        },
        
        {
            "tileMap": 1,
            "tileNo": 19
        },
        
        {
            "tileMap": 1,
            "tileNo": 25
        },
        
        {
            "tileMap": 1,
            "tileNo": 26
        },
        
        {
            "tileMap": 1,
            "tileNo": 17
        },
        
        {
            "tileMap": 1,
            "tileNo": 18
        },
        
        {
            "tileMap": 2,
            "tileNo": 1
        }
    ],
    
    "layers": [
        {
            "map": [   
                [1, 1, 1, 1, 1, 1, 1, 1, 1, 1, 1, 1],
                [1, 1, 1, 1, 3, 3, 3, 3, 1, 1, 1, 1],
                [1, 1, 1, 5, 0, 0, 0, 0, 6, 1, 1, 1],
                [1, 1, 5, 0, 0, 0, 0, 0, 0, 6, 1, 1],
                [1, 9, 0, 0, 0, 0, 0, 0, 0, 0, 6, 1],
                [1, 10, 0, 0, 0, 0, 0, 0, 0, 0, 0, 1],
                [2, 0, 0, 0, 0, 0, 0, 0, 0, 0, 0, 1],
                [2, 0, 0, 0, 0, 0, 0, 0, 0, 0, 0, 1],
                [2, 0, 0, 0, 0, 0, 0, 0, 0, 0, 0, 1],
                [2, 0, 0, 0, 0, 1, 1, 0, 0, 0, 0, 1],
                [2, 2, 0, 0, 0, 1, 1, 0, 0, 0, 0, 1],
                [2, 0, 0, 1, 1, 1, 1, 1, 1, 0, 0, 1],
                [2, 0, 0, 1, 1, 1, 1, 1, 1, 0, 0, 1],
                [2, 0, 0, 0, 0, 1, 1, 0, 0, 0, 0, 1],
                [2, 0, 0, 0, 0, 1, 1, 0, 0, 0, 0, 1],
                [2, 0, 0, 0, 0, 0, 0, 0, 0, 0, 0, 1],
                [1, 8, 0, 0, 0, 0, 0, 0, 0, 0, 0, 1],
                [1, 5, 0, 0, 0, 0, 0, 0, 0, 0, 0, 1],
                [2, 0, 0, 0, 0, 0, 0, 0, 0, 0, 0, 1],
                [2, 0, 0, 0, 7, 1, 1, 8, 0, 0, 0, 1],
                [2, 0, 0, 7, 1, 1, 1, 1, 8, 0, 0, 1],
                [2, 0, 0, 1, 1, 1, 1, 1, 1, 0, 0, 1],
                [2, 0, 0, 1, 1, 1, 1, 1, 1, 0, 0, 1],
                [2, 0, 0, 6, 1, 1, 1, 1, 5, 0, 0, 1],
                [2, 0, 0, 0, 6, 1, 1, 5, 0, 0, 0, 1],
                [2, 0, 0, 0, 0, 0, 0, 0, 0, 0, 0, 1],
                [2, 0, 0, 0, 0, 0, 0, 0, 0, 0, 0, 1],
                [2, 0, 0, 0, 0, 0, 0, 0, 0, 0, 0, 1],
                [1, 11, 0, 0, 0, 0, 0, 0, 0, 0, 0, 1],
                [1, 12, 0, 0, 0, 0, 0, 0, 0, 0, 7, 1],
                [1, 1, 8, 0, 0, 0, 0, 0, 0, 7, 1, 1],
                [1, 1, 1, 8, 0, 0, 0, 0, 7, 1, 1, 1],
                [1, 1, 1, 1, 4, 0, 0, 4, 1, 1, 1, 1],
                [1, 1, 1, 1, 1, 0, 0, 1, 1, 1, 1, 1],
                [2, 0, 0, 0, 0, 0, 0, 0, 0, 0, 0, 1],
                [2, 0, 0, 0, 0, 0, 0, 0, 0, 0, 0, 1],
                [2, 0, 0, 0, 0, 0, 0, 0, 0, 0, 0, 1],
                [2, 0, 0, 0, 0, 0, 0, 0, 0, 0, 0, 1],
                [2, 0, 0, 0, 0, 0, 0, 0, 0, 0, 0, 1],
                [2, 0, 0, 0, 0, 0, 0, 0, 0, 0, 0, 1],
                [2, 0, 0, 0, 0, 0, 0, 0, 0, 0, 0, 1],
                [2, 0, 0, 0, 0, 0, 0, 0, 0, 0, 0, 1],
                [2, 0, 0, 0, 0, 0, 0, 0, 0, 0, 0, 1],
                [2, 0, 0, 0, 0, 0, 0, 0, 0, 0, 0, 1],
                [2, 0, 0, 0, 0, 0, 0, 0, 0, 0, 0, 1],
                [2, 0, 0, 0, 0, 0, 0, 0, 0, 0, 0, 1],
                [2, 0, 0, 0, 0, 0, 0, 0, 0, 0, 0, 1],
                [2, 0, 0, 0, 0, 0, 0, 0, 0, 0, 0, 1],
                [2, 0, 0, 0, 0, 0, 0, 0, 0, 0, 0, 1],
                [2, 0, 0, 0, 0, 0, 0, 0, 0, 0, 0, 1],
                [2, 0, 0, 0, 0, 0, 0, 0, 0, 0, 0, 1],
                [2, 0, 0, 0, 0, 0, 0, 0, 0, 0, 0, 1],
                [2, 0, 0, 0, 0, 0, 0, 0, 0, 0, 0, 1],
                [2, 0, 0, 0, 0, 0, 0, 0, 0, 0, 0, 1],
                [2, 0, 0, 0, 0, 0, 0, 0, 0, 0, 0, 1],
                [2, 0, 0, 0, 0, 0, 0, 0, 0, 0, 0, 1],
                [2, 0, 0, 0, 0, 0, 0, 0, 0, 0, 0, 1],
                [2, 0, 0, 0, 0, 0, 0, 0, 0, 0, 0, 1],
                [2, 0, 0, 0, 0, 0, 0, 0, 0, 0, 0, 1],
                [2, 0, 0, 0, 0, 0, 0, 0, 0, 0, 0, 1],
                [2, 0, 0, 0, 0, 0, 0, 0, 0, 0, 0, 1],
                [2, 0, 0, 0, 0, 0, 0, 0, 0, 0, 0, 1],
                [2, 0, 0, 0, 0, 0, 0, 0, 0, 0, 0, 1],
                [2, 0, 0, 0, 0, 0, 0, 0, 0, 0, 0, 1],
                [2, 0, 0, 0, 0, 0, 0, 0, 0, 0, 0, 1],
                [2, 0, 0, 0, 0, 0, 0, 0, 0, 0, 0, 1],
                [2, 0, 0, 0, 0, 0, 0, 0, 0, 0, 0, 1],
                [2, 0, 0, 0, 0, 0, 0, 0, 0, 0, 0, 1],
                [2, 0, 0, 0, 0, 0, 0, 0, 0, 0, 0, 1],
                [2, 0, 0, 0, 0, 0, 0, 0, 0, 0, 0, 1],
                [2, 0, 0, 0, 0, 0, 0, 0, 0, 0, 0, 1],
                [2, 0, 0, 0, 0, 0, 0, 0, 0, 0, 0, 1],
                [2, 0, 0, 0, 0, 0, 0, 0, 0, 0, 0, 1],
                [2, 0, 0, 0, 0, 0, 0, 0, 0, 0, 0, 1],
                [2, 0, 0, 0, 0, 0, 0, 0, 0, 0, 0, 1],
                [2, 0, 0, 0, 0, 0, 0, 0, 0, 0, 0, 1],
                [2, 0, 0, 0, 0, 0, 0, 0, 0, 0, 0, 1],
                [2, 0, 0, 0, 0, 0, 0, 0, 0, 0, 0, 1],
                [2, 0, 0, 0, 0, 0, 0, 0, 0, 0, 0, 1],
                [2, 0, 0, 0, 0, 0, 0, 0, 0, 0, 0, 1],
                [2, 0, 0, 0, 0, 0, 0, 0, 0, 0, 0, 1],
                [2, 0, 0, 0, 0, 0, 0, 0, 0, 0, 0, 1],
                [2, 0, 0, 0, 0, 0, 0, 0, 0, 0, 0, 1],
                [2, 0, 0, 0, 0, 0, 0, 0, 0, 0, 0, 1],
                [2, 0, 0, 0, 0, 0, 0, 0, 0, 0, 0, 1],
                [2, 0, 0, 0, 0, 0, 0, 0, 0, 0, 0, 1],
                [2, 0, 0, 0, 0, 0, 0, 0, 0, 0, 0, 1],
                [2, 0, 0, 0, 0, 0, 0, 0, 0, 0, 0, 1],
                [2, 0, 0, 0, 0, 0, 0, 0, 0, 0, 0, 1],
                [2, 0, 0, 0, 0, 0, 0, 0, 0, 0, 0, 1],
                [2, 0, 0, 0, 0, 0, 0, 0, 0, 0, 0, 1],
                [2, 0, 0, 0, 0, 0, 0, 0, 0, 0, 0, 1],
                [2, 0, 0, 0, 0, 0, 0, 0, 0, 0, 0, 1],
                [2, 0, 0, 0, 0, 0, 0, 0, 0, 0, 0, 1],
                [2, 0, 0, 0, 0, 0, 0, 0, 0, 0, 0, 1],
                [2, 0, 0, 0, 0, 0, 0, 0, 0, 0, 0, 1],
                [2, 0, 0, 0, 0, 0, 0, 0, 0, 0, 0, 1],
                [2, 0, 0, 0, 0, 0, 0, 0, 0, 0, 0, 1],
                [2, 0, 0, 0, 0, 0, 0, 0, 0, 0, 0, 1],
                [2, 0, 0, 0, 0, 0, 0, 0, 0, 0, 0, 1],
                [2, 0, 0, 0, 0, 0, 0, 0, 0, 0, 0, 1],
                [2, 0, 0, 0, 0, 0, 0, 0, 0, 0, 0, 1],
                [2, 0, 0, 0, 0, 0, 0, 0, 0, 0, 0, 1],
                [2, 0, 0, 0, 0, 0, 0, 0, 0, 0, 0, 1],
                [2, 0, 0, 0, 0, 0, 0, 0, 0, 0, 0, 1],
                [2, 0, 0, 0, 0, 0, 0, 0, 0, 0, 0, 1],
                [2, 0, 0, 0, 0, 0, 0, 0, 0, 0, 0, 1],
                [2, 0, 0, 0, 0, 0, 0, 0, 0, 0, 0, 1],
                [2, 0, 0, 0, 0, 0, 0, 0, 0, 0, 0, 1],
                [2, 0, 0, 0, 0, 0, 0, 0, 0, 0, 0, 1],
                [2, 0, 0, 0, 0, 0, 0, 0, 0, 0, 0, 1],
                [2, 0, 0, 0, 0, 0, 0, 0, 0, 0, 0, 1],
                [2, 0, 0, 0, 0, 0, 0, 0, 0, 0, 0, 1],
                [2, 0, 0, 0, 0, 0, 0, 0, 0, 0, 0, 1],
                [2, 0, 0, 0, 0, 0, 0, 0, 0, 0, 0, 1],
                [2, 0, 0, 0, 0, 0, 0, 0, 0, 0, 0, 1],
                [2, 0, 0, 0, 0, 0, 0, 0, 0, 0, 0, 1],
                [2, 0, 0, 0, 0, 0, 0, 0, 0, 0, 0, 1],
                [2, 0, 0, 0, 0, 0, 0, 0, 0, 0, 0, 1],
                [2, 0, 0, 0, 0, 0, 0, 0, 0, 0, 0, 1],
                [2, 0, 0, 0, 0, 0, 0, 0, 0, 0, 0, 1],
                [2, 0, 0, 0, 0, 0, 0, 0, 0, 0, 0, 1],
                [2, 0, 0, 0, 0, 0, 0, 0, 0, 0, 0, 1],
                [1, 1, 1, 1, 1, 1, 1, 1, 1, 1, 1, 1]
            ]
        }
    ]
}