{
    "entities": [
        {"type": "spawn", "x": 10, "y": 11},
        {"type": "goomba", "x": 10, "y": 11}
    ],
    
    "tileMaps": {
        "smb3-grass": {
            "1": 10,
            "2": 2,
            "3": 11,
            "4": 9,
            "5": 27,
            "6": 35,
            "7": 38,
            "8": 19,
            "9": 25,
            "10": 26,
            "11": 17,
            "12": 18
        },
        "smb3-general": {
            "13": 1
        }
    },
    
    "layers": [
        {
            "map": [   
                [1, 1, 1, 1, 1, 1, 1, 1, 1, 1, 1, 1],
                [1, 1, 1, 1, 3, 3, 3, 3, 1, 1, 1, 1],
                [1, 1, 1, 5, 0, 0, 0, 0, 6, 1, 1, 1],
                [1, 1, 5, 0, 0, 0, 0, 0, 0, 6, 1, 1],
                [1, 9, 0, 0, 0, 0, 0, 0, 0, 0, 6, 1],
                [1, 10, 0, 0, 0, 0, 0, 0, 0, 0, 0, 1],
                [2, 0, 0, 0, 0, 0, 0, 0, 0, 0, 0, 1],
                [2, 0, 0, 0, 0, 1, 0, 0, 0, 0, 0, 1],
                [2, 0, 0, 0, 0, 1, 0, 0, 0, 0, 0, 1],
                [2, 0, 0, 0, 0, 1, 1, 0, 0, 0, 0, 1],
                [2, 0, 0, 0, 0, 1, 1, 0, 0, 0, 0, 1],
                [2, 0, 0, 1, 1, 1, 1, 1, 1, 0, 0, 1],
                [2, 0, 0, 1, 1, 1, 1, 1, 1, 0, 0, 1],
                [2, 0, 0, 0, 0, 1, 1, 0, 0, 0, 0, 1],
                [2, 0, 0, 0, 0, 1, 1, 0, 0, 0, 0, 1],
                [2, 0, 0, 0, 0, 0, 0, 0, 0, 0, 0, 1],
                [1, 8, 0, 0, 0, 0, 0, 0, 0, 0, 0, 1],
                [1, 5, 0, 0, 0, 0, 0, 0, 0, 0, 0, 1],
                [2, 0, 0, 0, 0, 0, 0, 0, 0, 0, 0, 1],
                [2, 0, 0, 0, 7, 1, 1, 8, 0, 0, 0, 1],
                [2, 0, 0, 7, 1, 1, 1, 1, 8, 0, 0, 1],
                [2, 0, 0, 1, 1, 1, 1, 1, 1, 0, 0, 1],
                [2, 0, 0, 1, 1, 1, 1, 1, 1, 0, 0, 1],
                [2, 0, 0, 6, 1, 1, 1, 1, 5, 0, 0, 1],
                [2, 0, 0, 0, 6, 1, 1, 5, 0, 0, 0, 1],
                [2, 0, 0, 0, 0, 0, 0, 0, 0, 0, 0, 1],
                [2, 0, 0, 0, 0, 0, 0, 0, 0, 0, 0, 1],
                [2, 0, 0, 0, 0, 0, 0, 0, 0, 0, 0, 1],
                [1, 11, 0, 0, 0, 0, 0, 0, 0, 0, 0, 1],
                [1, 12, 0, 0, 0, 0, 0, 0, 0, 0, 7, 1],
                [1, 1, 8, 0, 0, 0, 0, 0, 0, 7, 1, 1],
                [1, 1, 1, 8, 0, 0, 0, 0, 7, 1, 1, 1],
                [1, 1, 1, 1, 4, 0, 0, 4, 1, 1, 1, 1],
                [1, 1, 1, 1, 1, 0, 0, 1, 1, 1, 1, 1],
                [2, 0, 0, 0, 0, 0, 0, 0, 0, 0, 0, 1],
                [2, 0, 0, 0, 0, 0, 0, 0, 0, 0, 0, 1],
                [2, 0, 0, 0, 0, 0, 0, 0, 0, 0, 0, 1],
                [2, 0, 0, 0, 0, 0, 0, 0, 0, 0, 0, 1],
                [2, 0, 0, 0, 0, 0, 0, 0, 0, 0, 0, 1],
                [2, 0, 0, 0, 0, 0, 0, 0, 0, 0, 0, 1],
                [2, 0, 0, 0, 0, 0, 0, 0, 0, 0, 0, 1],
                [2, 0, 0, 0, 0, 0, 0, 0, 0, 0, 0, 1],
                [2, 0, 0, 0, 0, 0, 0, 0, 0, 0, 0, 1],
                [2, 0, 0, 0, 0, 0, 0, 0, 0, 0, 0, 1],
                [2, 0, 0, 0, 0, 0, 0, 0, 0, 0, 0, 1],
                [2, 0, 0, 0, 0, 0, 0, 0, 0, 0, 0, 1],
                [2, 0, 0, 0, 0, 0, 0, 0, 0, 0, 0, 1],
                [2, 0, 0, 0, 0, 0, 0, 0, 0, 0, 0, 1],
                [2, 0, 0, 0, 0, 0, 0, 0, 0, 0, 0, 1],
                [2, 0, 0, 0, 0, 0, 0, 0, 0, 0, 0, 1],
                [2, 0, 0, 0, 0, 0, 0, 0, 0, 0, 0, 1],
                [2, 0, 0, 0, 0, 0, 0, 0, 0, 0, 0, 1],
                [2, 0, 0, 0, 0, 0, 0, 0, 0, 0, 0, 1],
                [2, 0, 0, 0, 0, 0, 0, 0, 0, 0, 0, 1],
                [2, 0, 0, 0, 0, 0, 0, 0, 0, 0, 0, 1],
                [2, 0, 0, 0, 0, 0, 0, 0, 0, 0, 0, 1],
                [2, 0, 0, 0, 0, 0, 0, 0, 0, 0, 0, 1],
                [2, 0, 0, 0, 0, 0, 0, 0, 0, 0, 0, 1],
                [2, 0, 0, 0, 0, 0, 0, 0, 0, 0, 0, 1],
                [2, 0, 0, 0, 0, 0, 0, 0, 0, 0, 0, 1],
                [2, 0, 0, 0, 0, 0, 0, 0, 0, 0, 0, 1],
                [2, 0, 0, 0, 0, 0, 0, 0, 0, 0, 0, 1],
                [2, 0, 0, 0, 0, 0, 0, 0, 0, 0, 0, 1],
                [2, 0, 0, 0, 0, 0, 0, 0, 0, 0, 0, 1],
                [2, 0, 0, 0, 0, 0, 0, 0, 0, 0, 0, 1],
                [2, 0, 0, 0, 0, 0, 0, 0, 0, 0, 0, 1],
                [2, 0, 0, 0, 0, 0, 0, 0, 0, 0, 0, 1],
                [2, 0, 0, 0, 0, 0, 0, 0, 0, 0, 0, 1],
                [2, 0, 0, 0, 0, 0, 0, 0, 0, 0, 0, 1],
                [2, 0, 0, 0, 0, 0, 0, 0, 0, 0, 0, 1],
                [2, 0, 0, 0, 0, 0, 0, 0, 0, 0, 0, 1],
                [2, 0, 0, 0, 0, 0, 0, 0, 0, 0, 0, 1],
                [2, 0, 0, 0, 0, 0, 0, 0, 0, 0, 0, 1],
                [2, 0, 0, 0, 0, 0, 0, 0, 0, 0, 0, 1],
                [2, 0, 0, 0, 0, 0, 0, 0, 0, 0, 0, 1],
                [2, 0, 0, 0, 0, 0, 0, 0, 0, 0, 0, 1],
                [2, 0, 0, 0, 0, 0, 0, 0, 0, 0, 0, 1],
                [2, 0, 0, 0, 0, 0, 0, 0, 0, 0, 0, 1],
                [2, 0, 0, 0, 0, 0, 0, 0, 0, 0, 0, 1],
                [2, 0, 0, 0, 0, 0, 0, 0, 0, 0, 0, 1],
                [2, 0, 0, 0, 0, 0, 0, 0, 0, 0, 0, 1],
                [2, 0, 0, 0, 0, 0, 0, 0, 0, 0, 0, 1],
                [2, 0, 0, 0, 0, 0, 0, 0, 0, 0, 0, 1],
                [2, 0, 0, 0, 0, 0, 0, 0, 0, 0, 0, 1],
                [2, 0, 0, 0, 0, 0, 0, 0, 0, 0, 0, 1],
                [2, 0, 0, 0, 0, 0, 0, 0, 0, 0, 0, 1],
                [2, 0, 0, 0, 0, 0, 0, 0, 0, 0, 0, 1],
                [2, 0, 0, 0, 0, 0, 0, 0, 0, 0, 0, 1],
                [2, 0, 0, 0, 0, 0, 0, 0, 0, 0, 0, 1],
                [2, 0, 0, 0, 0, 0, 0, 0, 0, 0, 0, 1],
                [2, 0, 0, 0, 0, 0, 0, 0, 0, 0, 0, 1],
                [2, 0, 0, 0, 0, 0, 0, 0, 0, 0, 0, 1],
                [2, 0, 0, 0, 0, 0, 0, 0, 0, 0, 0, 1],
                [2, 0, 0, 0, 0, 0, 0, 0, 0, 0, 0, 1],
                [2, 0, 0, 0, 0, 0, 0, 0, 0, 0, 0, 1],
                [2, 0, 0, 0, 0, 0, 0, 0, 0, 0, 0, 1],
                [2, 0, 0, 0, 0, 0, 0, 0, 0, 0, 0, 1],
                [2, 0, 0, 0, 0, 0, 0, 0, 0, 0, 0, 1],
                [2, 0, 0, 0, 0, 0, 0, 0, 0, 0, 0, 1],
                [2, 0, 0, 0, 0, 0, 0, 0, 0, 0, 0, 1],
                [2, 0, 0, 0, 0, 0, 0, 0, 0, 0, 0, 1],
                [2, 0, 0, 0, 0, 0, 0, 0, 0, 0, 0, 1],
                [2, 0, 0, 0, 0, 0, 0, 0, 0, 0, 0, 1],
                [2, 0, 0, 0, 0, 0, 0, 0, 0, 0, 0, 1],
                [2, 0, 0, 0, 0, 0, 0, 0, 0, 0, 0, 1],
                [2, 0, 0, 0, 0, 0, 0, 0, 0, 0, 0, 1],
                [2, 0, 0, 0, 0, 0, 0, 0, 0, 0, 0, 1],
                [2, 0, 0, 0, 0, 0, 0, 0, 0, 0, 0, 1],
                [2, 0, 0, 0, 0, 0, 0, 0, 0, 0, 0, 1],
                [2, 0, 0, 0, 0, 0, 0, 0, 0, 0, 0, 1],
                [2, 0, 0, 0, 0, 0, 0, 0, 0, 0, 0, 1],
                [2, 0, 0, 0, 0, 0, 0, 0, 0, 0, 0, 1],
                [2, 0, 0, 0, 0, 0, 0, 0, 0, 0, 0, 1],
                [2, 0, 0, 0, 0, 0, 0, 0, 0, 0, 0, 1],
                [2, 0, 0, 0, 0, 0, 0, 0, 0, 0, 0, 1],
                [2, 0, 0, 0, 0, 0, 0, 0, 0, 0, 0, 1],
                [2, 0, 0, 0, 0, 0, 0, 0, 0, 0, 0, 1],
                [2, 0, 0, 0, 0, 0, 0, 0, 0, 0, 0, 1],
                [2, 0, 0, 0, 0, 0, 0, 0, 0, 0, 0, 1],
                [2, 0, 0, 0, 0, 0, 0, 0, 0, 0, 0, 1],
                [2, 0, 0, 0, 0, 0, 0, 0, 0, 0, 0, 1],
                [2, 0, 0, 0, 0, 0, 0, 0, 0, 0, 0, 1],
                [2, 0, 0, 0, 0, 0, 0, 0, 0, 0, 0, 1],
                [1, 1, 1, 1, 1, 1, 1, 1, 1, 1, 1, 1]
            ]
        },
        
        {
            "x": 5,
            "y": 6,
            "map": [
                [13],
                [13]
            ]
        }
    ]
}